                              wwwwwwwewwwwwww               wwwwwwwewwwwwww
                              w             w               w             w
                              w             w               w             w
                              w             w               w             w
                              w             w               w             w
                              w             w               w             w
                              w             w               w             w
                              e             e               e             e
                              w             w               w             w
                              w             w               w             w
                              w             w               w             w
                              w             w               w             w
                              w             w               w             w
                              w             w               w             w
                              wwwwwwwewwwwwww               wwwwwwwewwwwwww
                                  wwwewww                       wwwewww    
                                  w     w                       w     w    
                                  w     w                       w     w    
                                  w     w                       w     w    
                                  w     w                       w     w    
                                  w     w                       w     w    
                                  w     w                       w     w    
                                  w     w                       w     w    
                                  w     w                       w     w    
                                  w     w                       w     w    
                                  w     w                       w     w    
                                  w     w                       w     w    
                                  w     w                       w     w    
                                  w     w                       w     w    
                                  wwwewww                       wwwewww    
                              wwwwwwwewwwwwww               wwwwwwwewwwwwww
                              w             w               w             w
                              w             w               w             w
                              w             w               w             w
                              w             wwwwwwwwwwwwwwwww             w
                              w             ww             ww             w
                              w             ww             ww             w
                              e      s      ee             ee             e
                              w             ww             ww             w
                              w             ww             ww             w
                              w             wwwwwwwwwwwwwwwww             w
                              w             w               w             w
                              w             w               w             w
                              w             w               w             w
                              wwwwwwwewwwwwww               wwwwwwwewwwwwww
                                  wwwewww                                  
                                  w     w                                  
                                  w     w                                  
                                  w     w                                  
                                  w     w                                  
                                  w     w                                  
                                  w     w                                  
                                  w     w                                  
                                  w     w                                  
                                  w     w                                  
                                  w     w                                  
                                  w     w                                  
                                  w     w                                  
                                  w     w                                  
                                  wwwewww                                  
                              wwwwwwwewwwwwww               wwwwwwwewwwwwww
                              w             w               w             w
                              w             w               w             w
                              w             w               w             w
                              w             wwwwwwwwwwwwwwwww             w
                              w             ww             ww             w
                              w             ww             ww             w
                              e             ee             ee             e
                              w             ww             ww             w
                              w             ww             ww             w
                              w             wwwwwwwwwwwwwwwww             w
                              w             w               w             w
                              w             w               w             w
                              w             w               w             w
                              wwwwwwwewwwwwww               wwwwwwwewwwwwww
